###################################
#        #      ###=        #     #
# ###  ####  #####  # ## ###   #  #
# #C#                 #      ##   #
# #a# ##  ### ### = ######  ### ###
# #b# ##   #     # =    #     #   #
# #i# ##  ##### ###             ###
# #n#   #             #########   #
# #e# #######  ####   #Mahjong#   #
# #t#       #         #########   #
# ### #####==#  ####         =    E
#         #     #          ##     #
###################################