#################
#      #        #
#  ###  #  ###  #
#  # #     #    #
#  # ### ### ####
#          #    #
####### #### ####
#       #       #
# ##### # ####  #
#     #     #   #
# ##### ##### ###
#       #       #
# ############  #
#               E
#################
