###################################
#         #       =       #       #
# ##=#### ##### ##### ##### #=### #
# #   #      #              #   # #
# # ### ##### # #=### ##### ### # #
#     #         #   #     #   #   #
##### #=#####== ### #=# ### # ### #
#     #             # #   # #     #
# ### # ##### ##==### ### # ##### #
#   #   #   #         #         # #
### #=### # ######  ### ####### # #
#     #   #     #        ==       #
#==## ### ##### # #####  #### #####
#       #     = #           #     #
# #### ## ### # ### ##### ###=### #
#           # #         #         #
# ##### ### # ##### #=# ### === ###
#   #       =       #=            E
###################################