#################
#        #      #
# ## ###     # ##
# #  #   # #  ###
# # ###   ##    #
#       ###  #  #
##### # # # ### #
#   # #     #   #
# ##### ### # ###
#       #       E
#################