#####################################################
#        #             #      #                     #
# # #### ### # ### ### ## # ### ### # # #### ###  # #
# #      #   #   #        #       # # # #         # #
### #### # ### #### ##### ### ### # ### # ##### ### #
#   #        #      #             #           #     E
#####################################################